                                                                                                                                  
                                                                                                                                  
                                                                                                                                  
                                                                                                                                  
                                                                                                                                  
                                                                                                                                  
                                                                                                                                  
                                                                                                                                  
                                                                                                                                  
                                                                                                                                  
                                                                                                                                  
                                                @@@@@@@@@@@@@@@@@@@@@@@          @@@@@@@@@@@@@@@@@@@@@@@@@@@@@@@@@@@@@@@@@@@@@    
                                              @@@@@@@@@@@@@@@@@@@@@@@            @@@@@@@@@@@@@@@@@@@@  @@@@@@@@@@@@@@@@@@@@@@@    
                                            @@@@@@@@@@@@@@@@@@@@@@@              @@@@@@@@@@@@@@@@@@    @@@@@@@@@@@@@@@@@@@@@@@    
                                          @@@@@@@@@@@@@@@@@@@@@@@@               @@@@@@@@@@@@@@@@@     @@@@@@@@@@@@@@@@@@@@@@@    
                                        @@@@@@@@@@@@@@@@@@@@@@@@                 @@@@@@@@@@@@@@@       @@@@@@@@@@@@@@@@@@@@@@@    
                                      @@@@@@@@@@@@@@@@@@@@@@@@                   @@@@@@@@@@@@@         @@@@@@@@@@@@@@@@@@@@@@@    
                                     @@@@@@@@@@@@@@@@@@@@@@@                     @@@@@@@@@@@           @@@@@@@@@@@@@@@@@@@@@@@    
                                   @@@@@@@@@@@@@@@@@@@@@@@                       @@@@@@@@@             @@@@@@@@@@@@@@@@@@@@@@@    
                                 @@@@@@@@@@@@@@@@@@@@@@@                         @@@@@@@               @@@@@@@@@@@@@@@@@@@@@@@    
                               @@@@@@@@@@@@@@@@@@@@@@@@                          @@@@@@                @@@@@@@@@@@@@@@@@@@@@@@    
                             @@@@@@@@@@@@@@@@@@@@@@@@                            @@@@                  @@@@@@@@@@@@@@@@@@@@@@@    
                           @@@@@@@@@@@@@@@@@@@@@@@@                              @@                    @@@@@@@@@@@@@@@@@@@@@@@    
                          @@@@@@@@@@@@@@@@@@@@@@@                                                     @@@@@@@@@@@@@@@@@@@@@@@@    
                        @@@@@@@@@@@@@@@@@@@@@@@                                                     @@@@@@@@@@@@@@@@@@@@@@@@      
                      @@@@@@@@@@@@@@@@@@@@@@@                                                     @@@@@@@@@@@@@@@@@@@@@@@@        
                    @@@@@@@@@@@@@@@@@@@@@@@                                                      @@@@@@@@@@@@@@@@@@@@@@@          
                  @@@@@@@@@@@@@@@@@@@@@@@@                                                     @@@@@@@@@@@@@@@@@@@@@@@            
                 @@@@@@@@@@@@@@@@@@@@@@@                                                     @@@@@@@@@@@@@@@@@@@@@@@@             
               @@@@@@@@@@@@@@@@@@@@@@@                                                     @@@@@@@@@@@@@@@@@@@@@@@@               
             @@@@@@@@@@@@@@@@@@@@@@@                                                     @@@@@@@@@@@@@@@@@@@@@@@@                 
           @@@@@@@@@@@@@@@@@@@@@@@                                                      @@@@@@@@@@@@@@@@@@@@@@@                   
         @@@@@@@@@@@@@@@@@@@@@@@@                                                     @@@@@@@@@@@@@@@@@@@@@@@                     
       @@@@@@@@@@@@@@@@@@@@@@@@                                                     @@@@@@@@@@@@@@@@@@@@@@@                       
     @@@@@@@@@@@@@@@@@@@@@@@@                                                     @@@@@@@@@@@@@@@@@@@@@@@@                        
    @@@@@@@@@@@@@@@@@@@@@@@@@@@@@@@@@@@@@@@@@@@@@@@@@@@@@@@@@@@@@@@@@@@@         @@@@@@@@@@@@@@@@@@@@@@@                     @    
    @@@@@@@@@@@@@@@@@@@@@@@@@@@@@@@@@@@@@@@@@@@@@@@@@@@@@@@@@@@@@@@@@@@@         @@@@@@@@@@@@@@@@@@@@@@@                   @@@    
    @@@@@@@@@@@@@@@@@@@@@@@@@@@@@@@@@@@@@@@@@@@@@@@@@@@@@@@@@@@@@@@@@@@@         @@@@@@@@@@@@@@@@@@@@@@@                 @@@@@    
    @@@@@@@@@@@@@@@@@@@@@@@@@@@@@@@@@@@@@@@@@@@@@@@@@@@@@@@@@@@@@@@@@@@@         @@@@@@@@@@@@@@@@@@@@@@@               @@@@@@@    
    @@@@@@@@@@@@@@@@@@@@@@@@@@@@@@@@@@@@@@@@@@@@@@@@@@@@@@@@@@@@@@@@@@@@         @@@@@@@@@@@@@@@@@@@@@@@              @@@@@@@@    
    @@@@@@@@@@@@@@@@@@@@@@@@@@@@@@@@@@@@@@@@@@@@@@@@@@@@@@@@@@@@@@@@@@@@         @@@@@@@@@@@@@@@@@@@@@@@            @@@@@@@@@@    
    @@@@@@@@@@@@@@@@@@@@@@@@@@@@@@@@@@@@@@@@@@@@@@@@@@@@@@@@@@@@@@@@@@@@         @@@@@@@@@@@@@@@@@@@@@@@          @@@@@@@@@@@@    
    @@@@@@@@@@@@@@@@@@@@@@@@@@@@@@@@@@@@@@@@@@@@@@@@@@@@@@@@@@@@@@@@@@@@         @@@@@@@@@@@@@@@@@@@@@@@        @@@@@@@@@@@@@@    
    @@@@@@@@@@@@@@@@@@@@@@@@@@@@@@@@@@@@@@@@@@@@@@@@@@@@@@@@@@@@@@@@@@@@         @@@@@@@@@@@@@@@@@@@@@@@      @@@@@@@@@@@@@@@@    
    @@@@@@@@@@@@@@@@@@@@@@@@@@@@@@@@@@@@@@@@@@@@@@@@@@@@@@@@@@@@@@@@@@@@         @@@@@@@@@@@@@@@@@@@@@@@     @@@@@@@@@@@@@@@@@    
    @@@@@@@@@@@@@@@@@@@@@@@@@@@@@@@@@@@@@@@@@@@@@@@@@@@@@@@@@@@@@@@@@@@@         @@@@@@@@@@@@@@@@@@@@@@@   @@@@@@@@@@@@@@@@@@@    
                                                 @@@@@@@@@@@@@@@@@@@@@@@         @@@@@@@@@@@@@@@@@@@@@@@ @@@@@@@@@@@@@@@@@@@@@    
                                                 @@@@@@@@@@@@@@@@@@@@@@@         @@@@@@@@@@@@@@@@@@@@@@@@@@@@@@@@@@@@@@@@@@@@@    
                                                 @@@@@@@@@@@@@@@@@@@@@@@                                                          
                                                 @@@@@@@@@@@@@@@@@@@@@@@                                                          
                                                 @@@@@@@@@@@@@@@@@@@@@@@                                                          
                                                 @@@@@@@@@@@@@@@@@@@@@@@                                                          
                                                 @@@@@@@@@@@@@@@@@@@@@@@                                                          
                                                 @@@@@@@@@@@@@@@@@@@@@@@                                                          
                                                 @@@@@@@@@@@@@@@@@@@@@@@                                                          
                                                 @@@@@@@@@@@@@@@@@@@@@@@                                                          
                                                 @@@@@@@@@@@@@@@@@@@@@@@                                                          
                                                 @@@@@@@@@@@@@@@@@@@@@@@                                                          
                                                                                                                                  
                                                                                                                                  
                                                                                                                                  
                                                                                                                                  
                                                                                                                                  
                                                                                                                                  
                                                                                                                                  
                                                                                                                                  
                                                                                                                                  
                                                                                                                                  
                                                                                                                                  
                                                                                                                                  

                                                                                                                                  
																																                                                                                                                                    
																																																																	                                                                                                                                  
																																																																																																	                                                                                                                                    
																																																																																																																																		                                                                                                                                  


 ___  ___   _______    ___        ___        ________          ___       __    ________   ________   ___        ________     
|\  \|\  \ |\  ___ \  |\  \      |\  \      |\   __  \        |\  \     |\  \ |\   __  \ |\   __  \ |\  \      |\   ___ \    
\ \  \\\  \\ \   __/| \ \  \     \ \  \     \ \  \|\  \       \ \  \    \ \  \\ \  \|\  \\ \  \|\  \\ \  \     \ \  \_|\ \   
 \ \   __  \\ \  \_|/__\ \  \     \ \  \     \ \  \\\  \       \ \  \  __\ \  \\ \  \\\  \\ \   _  _\\ \  \     \ \  \ \\ \  
  \ \  \ \  \\ \  \_|\ \\ \  \____ \ \  \____ \ \  \\\  \       \ \  \|\__\_\  \\ \  \\\  \\ \  \\  \|\ \  \____ \ \  \_\\ \ 
   \ \__\ \__\\ \_______\\ \_______\\ \_______\\ \_______\       \ \____________\\ \_______\\ \__\\ _\ \ \_______\\ \_______\
    \|__|\|__| \|_______| \|_______| \|_______| \|_______|        \|____________| \|_______| \|__|\|__| \|_______| \|_______|