 ▄▄▄▄▄▄▄▄▄▄▄  ▄         ▄  ▄▄▄▄▄▄▄▄▄▄▄                                        
▐░░░░░░░░░░░▌▐░▌       ▐░▌▐░░░░░░░░░░░▌                                       
 ▀▀▀▀█░█▀▀▀▀ ▐░▌       ▐░▌▐░█▀▀▀▀▀▀▀▀▀                                        
     ▐░▌     ▐░▌       ▐░▌▐░░░░░░░░░░░▌                                       
      ▀       ▀         ▀  ▀▀▀▀▀▀▀▀▀▀▀                                        
                                                                              
▐░█▀▀▀▀▀▀▀█░▌▐░▌   ▐░▌ ▐░▌ ▀▀▀▀▀▀▀▀▀█░▌▐░▌ ▐░▌░▌ ▐░▌▐░█▀▀▀▀▀▀▀▀▀ ▐░█▀▀▀▀█░█▀▀ 
▐░▌       ▐░▌▐░▌    ▐░▌▐░▌          ▐░▌▐░▌▐░▌ ▐░▌▐░▌▐░▌          ▐░▌     ▐░▌  
▐░▌       ▐░▌▐░▌     ▐░▐░▌ ▄▄▄▄▄▄▄▄▄█░▌▐░▌░▌   ▐░▐░▌▐░█▄▄▄▄▄▄▄▄▄ ▐░▌      ▐░▌ 
     ▐░▌     ▐░▌                                                              
     ▐░▌     ▐░█▄▄▄▄▄▄▄▄▄                                                     
     ▐░▌     ▐░░░░░░░░░░░▌                                                    
 ▄▄▄▄▄▄▄▄▄▄▄  ▄            ▄         ▄  ▄▄▄▄▄▄▄▄▄▄▄  ▄         ▄  ▄▄▄▄▄▄▄▄▄▄▄ 
▐░░░░░░░░░░░▌▐░▌          ▐░▌       ▐░▌▐░░░░░░░░░░░▌▐░▌       ▐░▌▐░░░░░░░░░░░▌
▐░█▀▀▀▀▀▀▀█░▌▐░▌          ▐░▌       ▐░▌▐░█▀▀▀▀▀▀▀█░▌▐░▌       ▐░▌▐░█▀▀▀▀▀▀▀▀▀ 
▐░▌       ▐░▌▐░░░░░░░░░░░▌▐░░▌     ▐░░▌▐░▌       ▐░▌     ▐░▌     ▐░░░░░░░░░░░▌
 ▀         ▀  ▀▀▀▀▀▀▀▀▀▀▀  ▀▀       ▀▀  ▀         ▀       ▀       ▀▀▀▀▀▀▀▀▀▀▀ 
                                                                              
 ▀▀▀▀▀▀▀▀▀█░▌▐░░░░░░░░░░░▌                                                    
          ▐░▌▐░█▀▀▀▀▀▀▀▀▀                                                     
          ▐░▌▐░█▄▄▄▄▄▄▄▄▄                                                     
