111111111111111111111111111111
1P00000000000000000000000000C1
101111111111111111110111011101
101111111000000C00000111011101
100000000011111111110111011101
101111111011111111110111C11101
101111111011111111110111011101
1000000000000000000000000000E1
111111111111111111111111111111
