111111111111111111111111111111
1CCCCCCCCCCCCCCCCCCCCCCCCCCCC1
1C111111111111111111C111C111C1
1C1111111CCCCCCCCCCCC111C111C1
1PCCCCCCCC1111111111C111C111C1
1C1111111C1111111111C111C111C1
1C1111111C1111111111C111C111C1
10CCCCCCCCCCCCCCCCCCCCCCCCCCE1
111111111111111111111111111111
